11111111111111111111
100000100000000X0001
100C0010000000000001
10001110000111000001
100000000001000C0001
10X00000000101110001
10000P00011100010001
10000000000000011111
10000111100000000001
10000010000000000001
10000000000000000001
111111000000000C0001
10000000X00000000001
10000100111110000001
111111000000100E0001
1000C000000011111111
100000000000000X0001
10000111111100000001
10000000100000000001
11111111111111111111