11111111
1PC01E01
1C001011
10C00001
11111111
